Rk,Player,Pos,Age,Tm,G,GS,MP,FG,FGA,FG%,3P,3PA,3P%,2P,2PA,2P%,eFG%,FT,FTA,FT%,ORB,DRB,TRB,AST,STL,BLK,TOV,PF,PTS
1,Steven Adams\adamsst01,C,26,OKC,6,6,162,20,45,.444,0,0,,20,45,.444,.444,5,20,.250,20,43,63,12,2,4,9,13,45
2,Bam Adebayo\adebaba01,C,22,MIA,9,9,286,37,68,.544,1,5,.200,36,63,.571,.551,40,67,.597,21,63,84,44,16,14,23,25,115
3,LaMarcus Aldridge\aldrila01,C,34,SAS,8,8,262,61,118,.517,3,12,.250,58,106,.547,.530,27,32,.844,20,33,53,20,5,17,19,18,152
4,Nickeil Alexander-Walker\alexani01,SG,21,NOP,8,0,104,15,54,.278,8,28,.286,7,26,.269,.352,5,6,.833,2,16,18,24,3,0,6,13,43
5,Grayson Allen\allengr01,SG,24,MEM,5,0,84,11,35,.314,5,19,.263,6,16,.375,.386,10,12,.833,1,9,10,8,2,0,7,10,37
6,Jarrett Allen\allenja01,C,21,BRK,8,5,226,30,49,.612,0,0,,30,49,.612,.612,16,32,.500,27,50,77,8,4,14,11,16,76
7,Al-Farouq Aminu\aminual01,PF,29,ORL,9,0,202,13,43,.302,6,18,.333,7,25,.280,.372,11,15,.733,12,39,51,10,10,6,9,22,43
8,Kyle Anderson\anderky01,SF,26,MEM,8,0,166,22,44,.500,2,8,.250,20,36,.556,.523,11,18,.611,6,27,33,18,6,5,6,14,57
9,Ryan Anderson\anderry01,PF,31,HOU,2,0,14,2,7,.286,1,5,.200,1,2,.500,.357,0,0,,0,7,7,2,1,0,1,1,5
10,Giannis Antetokounmpo\antetgi01,PF,25,MIL,9,9,294,94,164,.573,10,36,.278,84,128,.656,.604,64,101,.634,21,106,127,65,12,15,37,39,262
11,Kostas Antetokounmpo\antetko01,PF,22,LAL,2,0,3,0,0,,0,0,,0,0,,,0,0,,0,1,1,0,0,0,0,0,0
12,Thanasis Antetokounmpo\antetth01,SF,27,MIL,1,0,6,1,2,.500,0,0,,1,2,.500,.500,0,0,,2,0,2,1,0,0,0,0,2
13,OG Anunoby\anunoog01,SF,22,TOR,8,8,272,44,77,.571,18,33,.545,26,44,.591,.688,4,8,.500,12,41,53,17,11,13,8,21,110
14,Ryan Arcidiacono\arcidry01,PG,25,CHI,9,0,128,10,22,.455,7,13,.538,3,9,.333,.614,8,9,.889,4,10,14,13,4,1,1,14,35
15,Trevor Ariza\arizatr01,SF,34,SAC,9,0,208,15,39,.385,12,30,.400,3,9,.333,.538,4,4,1.000,4,32,36,9,7,0,6,17,46
16,D.J. Augustin\augusdj01,PG,32,ORL,9,5,229,30,73,.411,6,22,.273,24,51,.471,.452,19,22,.864,5,9,14,36,3,0,10,8,85
17,Deandre Ayton\aytonde01,C,21,PHO,1,1,33,9,14,.643,0,0,,9,14,.643,.643,0,0,,3,8,11,0,1,4,0,2,18
18,Dwayne Bacon\bacondw01,SG,24,CHO,8,8,210,33,94,.351,6,25,.240,27,69,.391,.383,14,20,.700,7,24,31,13,7,1,13,19,86
19,Marvin Bagley\baglema01,PF,20,SAC,1,1,28,6,16,.375,0,0,,6,16,.375,.375,2,4,.500,4,6,10,0,1,1,1,1,14
20,Lonzo Ball\balllo01,PG,22,NOP,8,8,232,34,82,.415,18,49,.367,16,33,.485,.524,6,10,.600,6,30,36,49,13,1,19,14,92
21,Mo Bamba\bambamo01,C,21,ORL,7,0,92,15,40,.375,4,15,.267,11,25,.440,.425,1,4,.250,9,24,33,3,2,5,5,16,35
22,J.J. Barea\bareajo01,PG,35,DAL,1,0,16,3,6,.500,3,4,.750,0,2,.000,.750,2,2,1.000,1,0,1,3,0,0,2,0,11
23,Harrison Barnes\barneha02,SF,27,SAC,9,9,304,52,106,.491,14,37,.378,38,69,.551,.557,22,29,.759,14,33,47,15,12,2,7,13,140
24,RJ Barrett\barrerj01,SG,19,NYK,9,9,329,54,134,.403,11,31,.355,43,103,.417,.444,27,59,.458,12,45,57,35,12,3,24,24,146
25,Will Barton\bartowi01,SG,29,DEN,6,6,187,30,66,.455,10,20,.500,20,46,.435,.530,21,27,.778,10,32,42,11,8,6,10,7,91
26,Nicolas Batum\batumni01,SF,31,CHO,1,0,11,0,0,,0,0,,0,0,,,0,0,,1,3,4,2,0,0,2,2,0
27,Aron Baynes\baynear01,C,33,PHO,8,7,199,47,80,.588,16,34,.471,31,46,.674,.688,18,24,.750,16,29,45,26,3,7,10,33,128
28,Kent Bazemore\bazemke01,SF,30,POR,9,0,204,24,64,.375,10,29,.345,14,35,.400,.453,8,13,.615,2,38,40,14,9,7,14,35,66
29,Darius Bazley\bazleda01,PF,19,OKC,8,0,143,14,36,.389,7,20,.350,7,16,.438,.486,5,6,.833,2,31,33,5,3,2,9,7,40
30,Bradley Beal\bealbr01,SG,26,WAS,8,8,286,72,178,.404,22,75,.293,50,103,.485,.466,43,54,.796,10,28,38,52,9,2,31,22,209
31,Malik Beasley\beaslma01,SG,23,DEN,8,0,142,21,57,.368,12,29,.414,9,28,.321,.474,3,3,1.000,2,9,11,7,6,1,10,12,57
32,Marco Belinelli\belinma01,SG,33,SAS,8,0,134,12,50,.240,5,27,.185,7,23,.304,.290,5,7,.714,0,12,12,9,2,0,5,8,34
33,Jordan Bell\belljo01,PF,25,MIN,4,0,43,9,13,.692,0,1,.000,9,12,.750,.692,5,5,1.000,5,14,19,5,0,1,9,4,23
34,DeAndre' Bembry\bembrde01,SG,25,ATL,8,0,194,31,55,.564,1,6,.167,30,49,.612,.573,9,22,.409,11,24,35,25,11,1,16,18,72
35,Dāvis Bertāns\bertada01,PF,27,WAS,8,0,220,32,72,.444,25,56,.446,7,16,.438,.618,8,9,.889,2,21,23,9,4,3,5,22,97
36,Patrick Beverley\beverpa01,PG,31,LAC,9,9,277,25,69,.362,7,36,.194,18,33,.545,.413,8,11,.727,9,47,56,29,15,5,16,32,65
37,Khem Birch\birchkh01,C,27,ORL,4,0,45,1,5,.200,0,1,.000,1,4,.250,.200,2,8,.250,3,6,9,1,1,0,0,3,4
38,Goga Bitadze\bitadgo01,C,20,IND,6,2,109,14,29,.483,3,8,.375,11,21,.524,.534,9,12,.750,11,19,30,9,0,13,8,20,40
39,Bismack Biyombo\biyombi01,C,27,CHO,6,1,76,17,21,.810,0,0,,17,21,.810,.810,7,17,.412,7,9,16,6,1,4,6,11,41
40,Nemanja Bjelica\bjeline01,PF,31,SAC,9,8,211,32,60,.533,17,33,.515,15,27,.556,.675,2,2,1.000,12,29,41,20,9,3,10,19,83
41,Eric Bledsoe\bledser01,PG,30,MIL,9,9,237,53,119,.445,12,44,.273,41,75,.547,.496,20,27,.741,9,45,54,41,6,2,16,25,138
42,Bogdan Bogdanović\bogdabo01,SG,27,SAC,9,0,224,35,93,.376,24,60,.400,11,33,.333,.505,14,20,.700,1,22,23,30,9,1,13,20,108
43,Bojan Bogdanović\bogdabo02,SF,30,UTA,8,8,260,60,122,.492,25,55,.455,35,67,.522,.594,29,31,.935,1,35,36,16,7,4,23,20,174
44,Jonah Bolden\boldejo01,PF,24,PHI,1,0,2,1,1,1.000,0,0,,1,1,1.000,1.000,0,0,,0,0,0,0,1,0,0,0,2
45,Jordan Bone\bonejo01,PG,22,DET,2,0,4,0,3,.000,0,1,.000,0,2,.000,.000,0,0,,0,0,0,0,0,0,2,2,0
46,Isaac Bonga\bongais01,SF,20,WAS,7,7,149,13,29,.448,1,5,.200,12,24,.500,.466,6,9,.667,7,20,27,12,7,1,6,21,33
47,Devin Booker\bookede01,SG,23,PHO,8,8,276,74,140,.529,21,42,.500,53,98,.541,.604,36,39,.923,2,26,28,40,4,3,30,33,205
48,Chris Boucher\bouchch01,PF,27,TOR,6,0,36,1,9,.111,0,2,.000,1,7,.143,.111,7,8,.875,5,8,13,2,1,6,1,4,9
49,Ky Bowman\bowmaky01,PG,22,GSW,9,3,175,24,56,.429,6,15,.400,18,41,.439,.482,8,9,.889,1,16,17,21,6,0,11,15,62
50,Avery Bradley\bradlav01,SG,29,LAL,7,7,192,31,61,.508,7,21,.333,24,40,.600,.566,4,6,.667,2,23,25,7,8,1,8,17,73
51,Tony Bradley\bradlto01,C,22,UTA,6,0,49,13,19,.684,0,0,,13,19,.684,.684,5,10,.500,10,10,20,1,2,2,3,8,31
52,Jarrell Brantley\brantja01,PF,23,UTA,1,0,5,0,0,,0,0,,0,0,,,0,0,,0,3,3,1,0,1,0,0,0
53,Ignas Brazdeikis\brazdig01,SF,21,NYK,2,0,8,1,4,.250,0,1,.000,1,3,.333,.250,2,2,1.000,0,0,0,1,0,0,1,1,4
54,Mikal Bridges\bridgmi01,SF,23,PHO,8,0,157,15,32,.469,2,11,.182,13,21,.619,.500,6,8,.750,4,25,29,7,12,0,5,14,38
55,Miles Bridges\bridgmi02,SF,21,CHO,8,8,272,44,88,.500,14,36,.389,30,52,.577,.580,9,14,.643,11,32,43,15,2,5,21,17,111
56,Ryan Broekhoff\broekry01,SG,29,DAL,1,0,2,1,1,1.000,1,1,1.000,0,0,,1.500,0,0,,0,0,0,1,0,0,0,0,3
57,Malcolm Brogdon\brogdma01,PG,27,IND,9,9,308,65,142,.458,13,42,.310,52,100,.520,.504,46,47,.979,6,40,46,81,11,3,27,23,189
58,Dillon Brooks\brookdi01,SF,24,MEM,8,8,216,38,94,.404,14,35,.400,24,59,.407,.479,19,20,.950,7,25,32,13,8,4,9,36,109
59,Bruce Brown\brownbr01,SG,23,DET,10,7,279,31,79,.392,5,17,.294,26,62,.419,.424,14,23,.609,12,31,43,28,11,4,23,37,81
60,Charlie Brown\brownch02,SG,22,ATL,1,0,4,0,0,,0,0,,0,0,,,2,2,1.000,0,1,1,0,0,0,0,0,2
61,Jaylen Brown\brownja02,SG,23,BOS,4,4,118,25,49,.510,4,16,.250,21,33,.636,.551,10,14,.714,1,24,25,7,3,3,6,12,64
62,Sterling Brown\brownst02,SG,24,MIL,6,0,67,10,20,.500,4,10,.400,6,10,.600,.600,3,5,.600,6,19,25,3,2,1,3,5,27
63,Troy Brown\browntr01,SG,20,WAS,5,1,105,16,38,.421,4,11,.364,12,27,.444,.474,6,6,1.000,11,15,26,7,8,1,6,6,42
64,Jalen Brunson\brunsja01,PG,23,DAL,8,3,163,22,60,.367,6,24,.250,16,36,.444,.417,8,15,.533,7,18,25,28,4,0,8,9,58
65,Thomas Bryant\bryanth01,C,22,WAS,8,8,241,46,88,.523,6,23,.261,40,65,.615,.557,20,25,.800,18,59,77,20,6,12,15,17,118
66,Trey Burke\burketr01,G,27,PHI,1,0,18,2,7,.286,1,2,.500,1,5,.200,.357,0,0,,0,1,1,3,0,1,0,0,5
67,Alec Burks\burksal01,SG,28,GSW,6,0,149,27,58,.466,9,23,.391,18,35,.514,.543,17,19,.895,2,25,27,11,2,3,9,12,80
68,Deonte Burton\burtode02,SG,26,OKC,4,0,21,2,5,.400,2,4,.500,0,1,.000,.600,0,0,,0,4,4,0,1,0,2,3,6
69,Jimmy Butler\butleji01,SF,30,MIA,6,6,195,35,80,.438,5,19,.263,30,61,.492,.469,41,50,.820,14,25,39,33,17,4,13,8,116
70,Bruno Caboclo\cabocbr01,SF,24,MEM,6,0,62,8,23,.348,2,11,.182,6,12,.500,.391,0,0,,5,8,13,3,3,7,2,7,18
71,Kentavious Caldwell-Pope\caldwke01,SG,26,LAL,8,1,184,20,55,.364,5,20,.250,15,35,.429,.409,5,7,.714,3,15,18,14,6,1,7,17,50
72,Vlatko Čančar\cancavl01,SF,22,DEN,1,0,2,0,0,,0,0,,0,0,,,0,0,,0,0,0,0,0,0,0,0,0
73,Clint Capela\capelca01,C,25,HOU,8,8,222,49,80,.613,0,0,,49,80,.613,.613,10,22,.455,20,57,77,10,9,16,12,23,108
74,DeMarre Carroll\carrode01,SF,33,SAS,3,0,27,2,6,.333,0,1,.000,2,5,.400,.333,2,2,1.000,2,2,4,3,0,1,1,4,6
75,Jevon Carter\carteje01,PG,24,PHO,8,1,148,14,38,.368,10,26,.385,4,12,.333,.500,4,4,1.000,2,15,17,19,9,2,13,18,42
76,Vince Carter\cartevi01,SF,43,ATL,8,0,116,16,40,.400,4,24,.167,12,16,.750,.450,5,6,.833,1,16,17,4,4,1,3,11,41
77,Wendell Carter\cartewe01,C,20,CHI,9,9,240,45,77,.584,1,8,.125,44,69,.638,.591,24,38,.632,26,53,79,6,3,10,13,38,115
78,Michael Carter-Williams\cartemi01,PG,28,ORL,6,0,100,9,29,.310,3,9,.333,6,20,.300,.362,8,9,.889,9,17,26,9,8,4,5,11,29
79,Alex Caruso\carusal01,SG,25,LAL,7,0,124,12,32,.375,3,12,.250,9,20,.450,.422,2,3,.667,1,12,13,13,9,4,12,8,29
80,Willie Cauley-Stein\caulewi01,C,26,GSW,6,5,111,19,35,.543,0,0,,19,35,.543,.543,6,6,1.000,8,25,33,7,5,5,3,16,44
81,Tyson Chandler\chandty01,C,37,HOU,8,0,51,7,8,.875,0,0,,7,8,.875,.875,0,1,.000,5,12,17,2,3,1,1,9,14
82,Chris Chiozza\chiozch01,PG,24,WAS,2,0,35,2,9,.222,2,4,.500,0,5,.000,.333,0,0,,0,4,4,7,2,2,3,6,6
83,Marquese Chriss\chrisma01,PF,22,GSW,8,1,113,15,31,.484,1,3,.333,14,28,.500,.500,12,14,.857,11,23,34,14,7,3,12,18,43
84,Brandon Clarke\clarkbr01,PF,23,MEM,8,1,182,39,68,.574,3,10,.300,36,58,.621,.596,11,12,.917,13,38,51,8,6,13,7,14,92
85,Jordan Clarkson\clarkjo01,SG,27,CLE,8,0,184,37,89,.416,13,43,.302,24,46,.522,.489,28,30,.933,3,11,14,19,7,4,8,9,115
86,Nicolas Claxton\claxtni01,F,20,BRK,1,0,12,3,5,.600,0,0,,3,5,.600,.600,2,5,.400,5,1,6,1,0,0,0,2,8
87,Chris Clemons\clemoch01,PG,22,HOU,3,0,28,5,12,.417,4,11,.364,1,1,1.000,.583,2,2,1.000,2,1,3,1,0,1,2,5,16
88,John Collins\collijo01,PF,22,ATL,5,5,161,32,61,.525,9,19,.474,23,42,.548,.598,12,17,.706,10,34,44,8,5,10,7,17,85
89,Zach Collins\colliza01,PF,22,POR,3,3,86,9,19,.474,3,7,.429,6,12,.500,.553,6,6,1.000,4,8,12,6,0,2,6,11,27
90,Mike Conley\conlemi01,PG,32,UTA,9,9,269,40,115,.348,17,51,.333,23,64,.359,.422,25,32,.781,5,19,24,32,9,2,28,24,122
91,Pat Connaughton\connapa01,SG,27,MIL,7,0,118,14,38,.368,8,26,.308,6,12,.500,.474,1,1,1.000,1,19,20,11,1,3,1,9,37
92,Quinn Cook\cookqu01,PG,26,LAL,8,0,134,19,47,.404,6,20,.300,13,27,.481,.468,2,3,.667,3,9,12,18,2,1,7,6,46
93,Tyler Cook\cookty01,PF,22,CLE,3,0,5,2,3,.667,0,0,,2,3,.667,.667,0,0,,2,1,3,0,1,0,0,0,4
94,Robert Covington\covinro01,PF,29,MIN,8,8,209,37,83,.446,17,51,.333,20,32,.625,.548,15,16,.938,10,37,47,7,12,9,11,22,106
95,Torrey Craig\craigto01,SF,29,DEN,8,2,140,9,29,.310,3,15,.200,6,14,.429,.362,2,4,.500,8,23,31,10,3,8,5,20,23
96,Jae Crowder\crowdja01,SF,29,MEM,8,8,240,24,69,.348,15,51,.294,9,18,.500,.457,12,17,.706,8,34,42,22,8,3,11,19,75
97,Jarrett Culver\culveja01,SG,20,MIN,8,2,161,21,65,.323,9,30,.300,12,35,.343,.392,6,17,.353,6,16,22,16,5,0,13,17,57
98,Seth Curry\curryse01,SG,29,DAL,8,4,151,20,43,.465,11,27,.407,9,16,.563,.593,10,12,.833,3,7,10,11,7,2,6,12,61
99,Stephen Curry\curryst01,PG,31,GSW,4,4,112,27,66,.409,9,37,.243,18,29,.621,.477,18,18,1.000,4,16,20,26,5,2,15,10,81
100,Troy Daniels\danietr01,SG,28,LAL,8,0,120,13,42,.310,9,33,.273,4,9,.444,.417,3,3,1.000,1,9,10,6,3,0,3,3,38
101,Anthony Davis\davisan02,PF,26,LAL,8,8,278,74,154,.481,5,20,.250,69,134,.515,.497,59,66,.894,22,62,84,26,9,24,23,23,212
102,Ed Davis\davised01,C,30,UTA,6,0,73,4,10,.400,0,0,,4,10,.400,.400,2,4,.500,9,22,31,1,1,3,5,14,10
103,Terence Davis\daviste02,SG,22,TOR,8,0,70,4,14,.286,2,7,.286,2,7,.286,.357,4,4,1.000,3,11,14,6,4,1,3,14,14
104,Dewayne Dedmon\dedmode01,C,30,SAC,9,4,154,16,47,.340,5,24,.208,11,23,.478,.394,9,9,1.000,18,27,45,5,3,6,17,25,46
105,Matthew Dellavedova\dellama01,PG,29,CLE,6,0,95,8,26,.308,1,16,.063,7,10,.700,.327,4,5,.800,2,8,10,13,3,0,6,10,21
106,DeMar DeRozan\derozde01,SG,30,SAS,8,8,270,63,122,.516,0,2,.000,63,120,.525,.516,34,45,.756,4,36,40,38,9,5,29,17,160
107,Cheick Diallo\diallch01,C,23,PHO,4,0,8,2,2,1.000,0,0,,2,2,1.000,1.000,2,2,1.000,0,0,0,0,0,0,2,2,6
108,Hamidou Diallo\diallha01,SG,21,OKC,8,0,175,32,68,.471,2,12,.167,30,56,.536,.485,11,18,.611,14,24,38,6,10,4,11,19,77
109,Gorgui Dieng\dienggo01,C,30,MIN,5,2,58,13,26,.500,2,8,.250,11,18,.611,.538,7,8,.875,5,12,17,6,3,5,4,3,35
110,Spencer Dinwiddie\dinwisp01,SG,26,BRK,8,0,202,42,98,.429,14,43,.326,28,55,.509,.500,34,43,.791,3,17,20,37,5,3,22,28,132
111,Donte DiVincenzo\divindo01,SG,23,MIL,6,0,89,14,36,.389,9,20,.450,5,16,.313,.514,2,4,.500,5,14,19,6,5,2,6,11,39
112,Luka Dončić\doncilu01,PG,20,DAL,8,8,286,75,159,.472,23,72,.319,52,87,.598,.544,52,62,.839,13,70,83,74,9,1,42,23,225
113,Damyean Dotson\dotsoda01,SG,25,NYK,5,0,31,3,6,.500,2,3,.667,1,3,.333,.667,2,3,.667,0,3,3,2,0,0,3,2,10
114,Goran Dragić\dragigo01,PG,33,MIA,9,0,254,48,101,.475,24,53,.453,24,48,.500,.594,30,42,.714,2,31,33,43,4,3,23,15,150
115,Andre Drummond\drumman01,C,26,DET,10,10,357,88,155,.568,0,8,.000,88,147,.599,.568,36,53,.679,45,135,180,36,15,21,40,40,212
116,Jared Dudley\dudleja01,SF,34,LAL,5,0,33,2,3,.667,2,2,1.000,0,1,.000,1.000,0,0,,0,2,2,1,1,0,0,5,6
117,Kris Dunn\dunnkr01,PG,25,CHI,9,0,183,25,55,.455,1,12,.083,24,43,.558,.464,4,7,.571,5,17,22,24,20,2,7,28,55
118,Carsen Edwards\edwarca01,PG,21,BOS,6,0,78,10,31,.323,5,19,.263,5,12,.417,.403,4,6,.667,2,8,10,6,2,2,1,5,29
119,Wayne Ellington\ellinwa01,SG,32,NYK,7,1,129,13,43,.302,10,38,.263,3,5,.600,.419,0,1,.000,0,13,13,9,2,1,6,8,36
120,Joel Embiid\embiijo01,C,25,PHI,5,5,140,35,80,.438,7,20,.350,28,60,.467,.481,39,47,.830,17,45,62,15,4,8,19,23,116
121,James Ennis\ennisja01,SF,29,PHI,8,0,117,15,28,.536,2,7,.286,13,21,.619,.571,11,16,.688,12,24,36,5,4,1,7,14,43
122,Drew Eubanks\eubandr01,PF,22,SAS,1,0,2,0,2,.000,0,0,,0,2,.000,.000,0,0,,2,1,3,0,0,0,1,1,0
123,Jacob Evans\evansja02,SG,22,GSW,3,0,43,5,12,.417,4,8,.500,1,4,.250,.583,4,4,1.000,1,4,5,2,0,0,1,2,18
124,Tacko Fall\fallta01,C,24,BOS,1,0,4,2,4,.500,0,0,,2,4,.500,.500,0,0,,0,3,3,0,0,0,1,2,4
125,Derrick Favors\favorde01,C,28,NOP,5,3,88,15,26,.577,0,1,.000,15,25,.600,.577,0,2,.000,14,19,33,8,1,1,10,10,30
126,Terrance Ferguson\fergute01,SG,21,OKC,8,8,178,10,24,.417,5,14,.357,5,10,.500,.521,3,3,1.000,5,11,16,7,3,3,5,23,28
127,Bruno Fernando\fernabr01,C,21,ATL,8,0,100,18,29,.621,2,6,.333,16,23,.696,.655,4,9,.444,9,17,26,9,2,3,8,12,42
128,Yogi Ferrell\ferreyo01,PG,26,SAC,5,0,25,4,10,.400,1,4,.250,3,6,.500,.450,3,4,.750,0,3,3,3,1,1,1,2,12
129,Dorian Finney-Smith\finnedo01,PF,26,DAL,8,5,211,20,47,.426,8,26,.308,12,21,.571,.511,11,17,.647,19,29,48,5,6,1,9,15,59
130,Bryn Forbes\forbebr01,SG,26,SAS,8,8,226,40,97,.412,21,58,.362,19,39,.487,.521,15,17,.882,3,26,29,11,4,0,6,15,116
131,Evan Fournier\fournev01,SG,27,ORL,9,9,251,49,107,.458,14,42,.333,35,65,.538,.523,21,24,.875,1,30,31,25,6,2,18,21,133
132,De'Aaron Fox\foxde01,PG,22,SAC,9,9,288,55,128,.430,10,30,.333,45,98,.459,.469,44,62,.710,5,31,36,63,7,5,37,27,164
133,Melvin Frazier\frazime01,SG,23,ORL,1,0,6,1,5,.200,0,1,.000,1,4,.250,.200,0,0,,1,0,1,0,0,0,0,0,2
134,Tim Frazier\fraziti01,PG,29,DET,6,4,93,8,31,.258,3,10,.300,5,21,.238,.306,6,8,.750,2,5,7,20,5,0,6,14,25
135,Markelle Fultz\fultzma01,SG,21,ORL,9,4,210,37,80,.463,4,21,.190,33,59,.559,.488,11,14,.786,6,12,18,27,12,2,17,22,89
136,Wenyen Gabriel\gabriwe01,PF,22,SAC,5,0,34,3,12,.250,1,6,.167,2,6,.333,.292,4,7,.571,3,3,6,3,1,1,3,4,11
137,Daniel Gafford\gaffoda01,PF,21,CHI,2,0,6,0,0,,0,0,,0,0,,,0,0,,0,1,1,0,0,0,0,1,0
138,Danilo Gallinari\gallida01,PF,31,OKC,8,8,233,47,102,.461,25,55,.455,22,47,.468,.583,32,34,.941,2,36,38,11,6,1,10,14,151
139,Langston Galloway\gallola01,SG,28,DET,10,0,241,31,76,.408,17,40,.425,14,36,.389,.520,31,33,.939,3,19,22,19,7,4,5,10,110
140,Darius Garland\garlada01,PG,20,CLE,8,8,221,27,83,.325,8,29,.276,19,54,.352,.373,6,8,.750,3,9,12,29,7,0,19,10,68
141,Marc Gasol\gasolma01,C,35,TOR,8,8,209,18,53,.340,9,24,.375,9,29,.310,.425,10,12,.833,7,49,56,16,2,3,13,27,55
142,Rudy Gay\gayru01,PF,33,SAS,8,0,184,31,68,.456,7,29,.241,24,39,.615,.507,15,19,.789,13,42,55,19,3,4,13,11,84
143,Taj Gibson\gibsota01,C,34,NYK,7,1,99,12,23,.522,0,3,.000,12,20,.600,.522,4,6,.667,7,15,22,8,2,1,5,13,28
144,Harry Giles\gilesha01,F-C,21,SAC,1,0,8,1,2,.500,0,0,,1,2,.500,.500,2,2,1.000,0,1,1,0,0,1,0,1,4
145,Shai Gilgeous-Alexander\gilgesh01,SG,21,OKC,8,8,280,65,134,.485,14,35,.400,51,99,.515,.537,32,44,.727,7,40,47,25,5,7,14,11,176
146,Rudy Gobert\goberru01,C,27,UTA,9,9,308,31,52,.596,0,0,,31,52,.596,.596,36,55,.655,20,97,117,9,10,10,23,34,98
147,Aaron Gordon\gordoaa01,PF,24,ORL,9,9,275,48,103,.466,8,31,.258,40,72,.556,.505,19,27,.704,17,36,53,24,8,4,14,27,123
148,Eric Gordon\gordoer01,SG,31,HOU,7,2,214,25,90,.278,14,60,.233,11,30,.367,.356,8,12,.667,2,10,12,6,5,1,6,16,72
149,Devonte' Graham\grahade01,PG,24,CHO,8,0,248,41,98,.418,23,55,.418,18,43,.419,.536,31,39,.795,5,26,31,56,6,1,20,15,136
150,Treveon Graham\grahatr01,SG,26,MIN,8,7,200,20,58,.345,5,22,.227,15,36,.417,.388,7,7,1.000,7,21,28,15,10,1,6,15,52
151,Jerami Grant\grantje01,PF,25,DEN,8,0,182,25,60,.417,6,25,.240,19,35,.543,.467,11,17,.647,6,18,24,9,4,4,9,14,67
152,Danny Green\greenda02,SG,32,LAL,8,8,213,28,63,.444,18,41,.439,10,22,.455,.587,4,6,.667,4,20,24,9,12,3,8,25,78
153,Draymond Green\greendr01,PF,29,GSW,5,5,144,18,42,.429,4,13,.308,14,29,.483,.476,7,10,.700,4,35,39,26,7,0,7,11,47
154,JaMychal Green\greenja01,PF,29,LAC,9,0,194,26,58,.448,19,41,.463,7,17,.412,.612,10,12,.833,8,43,51,2,2,2,7,27,81
155,Javonte Green\greenja02,SG,26,BOS,5,0,22,5,9,.556,0,2,.000,5,7,.714,.556,2,4,.500,0,3,3,1,0,0,0,0,12
156,Jeff Green\greenje02,PF,33,UTA,9,1,167,16,50,.320,11,30,.367,5,20,.250,.430,7,12,.583,2,17,19,4,5,3,9,15,50
157,Marko Guduric\gudurma01,SG,24,MEM,8,0,140,15,40,.375,4,18,.222,11,22,.500,.425,3,3,1.000,6,18,24,13,1,2,11,8,37
158,Rui Hachimura\hachiru01,SF,21,WAS,8,8,228,49,100,.490,4,16,.250,45,84,.536,.510,7,8,.875,18,31,49,12,5,1,9,14,109
159,Tim Hardaway\hardati02,SG,27,DAL,8,0,187,29,80,.363,15,48,.313,14,32,.438,.456,14,18,.778,3,16,19,12,1,0,4,18,87
160,James Harden\hardeja01,SG,30,HOU,8,8,283,74,191,.387,30,111,.270,44,80,.550,.466,114,126,.905,10,30,40,65,10,6,46,26,292
161,Maurice Harkless\harklma01,PF,26,LAC,9,0,180,21,39,.538,3,10,.300,18,29,.621,.577,3,6,.500,5,20,25,7,11,4,9,31,48
162,Jared Harper\harpeja01,PG,22,PHO,1,0,2,0,1,.000,0,1,.000,0,0,,.000,0,0,,0,0,0,0,0,0,0,0,0
163,Montrezl Harrell\harremo01,C,26,LAC,9,1,263,73,108,.676,0,1,.000,73,107,.682,.676,38,58,.655,24,36,60,20,7,9,19,22,184
164,Gary Harris\harriga01,SG,25,DEN,8,8,247,32,79,.405,12,32,.375,20,47,.426,.481,11,14,.786,4,21,25,13,10,1,10,14,87
165,Joe Harris\harrijo01,SG,28,BRK,8,8,266,44,84,.524,26,48,.542,18,36,.500,.679,5,7,.714,10,21,31,14,6,2,13,22,119
166,Tobias Harris\harrito02,SF,27,PHI,8,8,286,58,117,.496,10,34,.294,48,83,.578,.538,25,33,.758,5,65,70,24,11,4,17,28,151
167,Shaquille Harrison\harrish01,PG,26,CHI,5,0,21,3,10,.300,0,1,.000,3,9,.333,.300,4,6,.667,0,7,7,2,0,1,0,4,10
168,Josh Hart\hartjo01,SF,24,NOP,8,3,224,34,80,.425,16,48,.333,18,32,.563,.525,13,14,.929,12,44,56,8,10,4,11,22,97
169,Jaxson Hayes\hayesja02,C,19,NOP,5,0,78,15,24,.625,0,2,.000,15,22,.682,.625,5,11,.455,9,12,21,5,4,2,3,19,35
170,Gordon Hayward\haywago01,SF,29,BOS,7,7,235,57,101,.564,12,27,.444,45,74,.608,.624,16,19,.842,6,49,55,32,5,1,14,14,142
171,John Henson\hensojo01,PF,29,CLE,1,0,8,1,2,.500,0,1,.000,1,1,1.000,.500,1,6,.167,2,1,3,0,2,2,1,0,3
172,Juan Hernangómez\hernaju01,PF,24,DEN,3,0,19,1,5,.200,1,4,.250,0,1,.000,.300,0,0,,0,1,1,0,0,1,0,0,3
173,Willy Hernangómez\hernawi01,C,25,CHO,3,0,28,5,10,.500,1,2,.500,4,8,.500,.550,0,0,,4,2,6,1,1,2,2,1,11
174,Tyler Herro\herroty01,SG,20,MIA,9,3,263,41,98,.418,16,43,.372,25,55,.455,.500,20,24,.833,2,41,43,20,8,0,16,12,118
175,Mario Hezonja\hezonma01,SF,24,POR,9,2,207,18,55,.327,7,21,.333,11,34,.324,.391,8,10,.800,8,51,59,8,8,2,8,26,51
176,Buddy Hield\hieldbu01,SG,27,SAC,9,9,272,61,144,.424,32,79,.405,29,65,.446,.535,9,11,.818,7,32,39,14,6,5,25,23,163
177,George Hill\hillge01,PG,33,MIL,9,0,205,34,60,.567,15,26,.577,19,34,.559,.692,10,15,.667,11,15,26,24,9,1,4,15,93
178,Solomon Hill\hillso01,SF,28,MEM,6,0,106,15,31,.484,7,16,.438,8,15,.533,.597,7,10,.700,3,14,17,8,4,1,8,10,44
179,Aaron Holiday\holidaa01,PG,23,IND,7,2,129,15,46,.326,8,18,.444,7,28,.250,.413,4,5,.800,2,14,16,17,6,1,7,10,42
180,Jrue Holiday\holidjr01,SG,29,NOP,6,6,205,34,88,.386,10,31,.323,24,57,.421,.443,9,13,.692,5,24,29,36,12,4,13,13,87
181,Justin Holiday\holidju01,SG,30,IND,9,0,208,20,56,.357,12,37,.324,8,19,.421,.464,6,9,.667,3,32,35,11,6,9,6,19,58
182,Rondae Hollis-Jefferson\holliro01,SF,25,TOR,1,0,4,0,0,,0,0,,0,0,,,1,2,.500,0,0,0,0,0,0,0,1,1
183,Richaun Holmes\holmeri01,C,26,SAC,9,5,226,40,63,.635,0,0,,40,63,.635,.635,10,14,.714,22,41,63,8,6,12,10,33,90
184,Rodney Hood\hoodro01,SF,27,POR,9,9,263,34,71,.479,15,31,.484,19,40,.475,.585,12,15,.800,7,28,35,5,8,4,9,23,95
185,Al Horford\horfoal01,PF,33,PHI,8,8,256,51,117,.436,14,41,.341,37,76,.487,.496,12,19,.632,19,41,60,31,9,10,8,27,128
186,Danuel House\houseda01,SF,26,HOU,8,7,248,35,73,.479,22,48,.458,13,25,.520,.630,13,16,.813,6,37,43,6,5,9,6,16,105
187,Dwight Howard\howardw01,C,34,LAL,8,0,167,23,30,.767,0,0,,23,30,.767,.767,3,9,.333,17,44,61,9,5,15,7,33,49
188,Kevin Huerter\huertke01,SG,21,ATL,8,1,179,23,59,.390,11,33,.333,12,26,.462,.483,10,13,.769,5,21,26,23,6,3,12,16,67
189,De'Andre Hunter\huntede01,SF,22,ATL,8,8,219,24,65,.369,6,26,.231,18,39,.462,.415,12,15,.800,4,30,34,11,4,2,13,15,66
190,Chandler Hutchison\hutchch01,SF,23,CHI,2,0,33,4,8,.500,1,2,.500,3,6,.500,.563,5,10,.500,1,6,7,1,0,0,2,5,14
191,Serge Ibaka\ibakase01,C,30,TOR,8,0,183,44,84,.524,5,16,.313,39,68,.574,.554,19,23,.826,7,45,52,6,5,10,17,19,112
192,Ersan İlyasova\ilyaser01,PF,32,MIL,9,0,152,19,49,.388,8,29,.276,11,20,.550,.469,10,12,.833,10,39,49,5,5,5,5,22,56
193,Joe Ingles\inglejo01,SF,32,UTA,9,1,251,22,60,.367,13,41,.317,9,19,.474,.475,5,6,.833,2,34,36,30,7,1,12,24,62
194,Brandon Ingram\ingrabr01,PF,22,NOP,8,8,253,79,150,.527,20,45,.444,59,105,.562,.593,30,39,.769,9,48,57,31,6,8,21,23,208
195,Kyrie Irving\irvinky01,PG,27,BRK,8,8,275,87,186,.468,27,68,.397,60,118,.508,.540,54,58,.931,7,39,46,60,10,5,21,22,255
196,Jonathan Isaac\isaacjo01,SF,22,ORL,9,9,270,40,81,.494,12,33,.364,28,48,.583,.568,19,21,.905,11,53,64,14,14,28,14,22,111
197,Wesley Iwundu\iwundwe01,SF,25,ORL,3,0,28,1,11,.091,0,5,.000,1,6,.167,.091,2,4,.500,1,6,7,1,0,0,2,1,4
198,Frank Jackson\jacksfr01,PG,21,NOP,8,0,154,35,77,.455,12,32,.375,23,45,.511,.532,13,16,.813,3,6,9,12,7,1,14,17,95
199,Jaren Jackson\jacksja02,C,20,MEM,7,7,171,29,69,.420,5,22,.227,24,47,.511,.457,17,21,.810,10,26,36,7,3,8,16,29,80
200,Justin Jackson\jacksju01,SF,24,DAL,8,0,101,17,34,.500,6,14,.429,11,20,.550,.588,7,8,.875,4,15,19,3,1,0,4,8,47
201,Reggie Jackson\jacksre01,PG,29,DET,2,2,36,4,11,.364,1,5,.200,3,6,.500,.409,1,1,1.000,1,4,5,8,0,0,1,2,10
202,Justin James\jamesju01,SG,23,SAC,3,0,12,3,7,.429,0,2,.000,3,5,.600,.429,1,4,.250,0,2,2,1,1,1,0,0,7
203,LeBron James\jamesle01,SF,35,LAL,8,8,281,75,154,.487,15,45,.333,60,109,.550,.536,43,56,.768,6,56,62,84,11,5,30,15,208
204,Amile Jefferson\jeffeam01,PF,26,ORL,2,0,9,3,3,1.000,0,0,,3,3,1.000,1.000,0,0,,2,1,3,2,0,0,1,0,6
205,Alize Johnson\johnsal02,PF,23,IND,1,0,8,1,2,.500,0,0,,1,2,.500,.500,0,0,,0,1,1,0,0,0,0,1,2
206,Cameron Johnson\johnsca02,SF,23,PHO,6,0,82,12,27,.444,6,17,.353,6,10,.600,.556,3,4,.750,2,10,12,2,2,0,3,11,33
207,James Johnson\johnsja01,PF,32,MIA,4,0,57,8,17,.471,2,8,.250,6,9,.667,.529,2,4,.500,2,8,10,4,3,2,3,4,20
208,Stanley Johnson\johnsst04,SF,23,TOR,3,0,11,2,5,.400,1,3,.333,1,2,.500,.500,0,0,,1,3,4,0,1,0,4,4,5
209,Tyler Johnson\johnsty01,PG,27,PHO,8,0,152,22,47,.468,10,24,.417,12,23,.522,.574,7,8,.875,1,11,12,13,2,1,8,14,61
210,Nikola Jokić\jokicni01,C,24,DEN,8,8,245,50,109,.459,9,34,.265,41,75,.547,.500,21,27,.778,14,64,78,47,10,6,23,28,130
211,Damian Jones\jonesda03,C,24,ATL,7,0,88,12,17,.706,1,2,.500,11,15,.733,.735,3,6,.500,4,10,14,2,3,3,3,18,28
212,Derrick Jones\jonesde02,SF,22,MIA,4,0,57,12,20,.600,1,4,.250,11,16,.688,.625,3,3,1.000,3,5,8,2,3,0,2,11,28
213,Tyus Jones\jonesty01,PG,23,MEM,8,0,170,24,60,.400,2,14,.143,22,46,.478,.417,11,16,.688,0,10,10,38,11,0,11,11,61
214,DeAndre Jordan\jordade01,C,31,BRK,7,3,148,18,32,.563,0,0,,18,32,.563,.563,7,15,.467,16,49,65,11,3,9,10,18,43
215,Cory Joseph\josepco01,PG,28,SAC,9,0,155,23,53,.434,3,13,.231,20,40,.500,.462,9,9,1.000,7,12,19,20,3,4,12,15,58
216,Mfiondu Kabengele\kabenmf01,C,22,LAC,3,0,7,1,2,.500,1,2,.500,0,0,,.750,0,0,,0,1,1,0,0,1,0,1,3
217,Frank Kaminsky\kaminfr01,C,26,PHO,8,0,191,24,66,.364,5,28,.179,19,38,.500,.402,27,36,.750,6,39,45,19,1,3,15,17,80
218,Enes Kanter\kanteen01,C,27,BOS,1,1,25,5,8,.625,0,1,.000,5,7,.714,.625,2,7,.286,3,3,6,2,0,0,0,3,12
219,Luke Kennard\kennalu01,SG,23,DET,10,7,326,58,128,.453,28,66,.424,30,62,.484,.563,36,41,.878,3,34,37,43,2,0,17,20,180
220,Stanton Kidd\kiddst01,SF,27,UTA,3,0,13,0,3,.000,0,1,.000,0,2,.000,.000,0,0,,0,2,2,1,0,0,2,2,0
221,Michael Kidd-Gilchrist\kiddgmi01,SF,26,CHO,1,0,10,2,7,.286,1,1,1.000,1,6,.167,.357,0,0,,1,3,4,0,0,0,1,1,5
222,Maxi Kleber\klebima01,PF,28,DAL,7,2,192,23,51,.451,10,29,.345,13,22,.591,.549,10,11,.909,10,37,47,8,2,8,7,19,66
223,Brandon Knight\knighbr03,PG,28,CLE,3,0,38,5,15,.333,5,13,.385,0,2,.000,.500,1,2,.500,0,3,3,7,1,0,3,6,16
224,Kevin Knox\knoxke01,SF,20,NYK,9,0,206,31,70,.443,17,36,.472,14,34,.412,.564,15,22,.682,5,26,31,11,6,1,7,16,94
225,Furkan Korkmaz\korkmfu01,SG,22,PHI,8,1,164,23,50,.460,16,34,.471,7,16,.438,.620,9,12,.750,1,17,18,7,1,3,7,12,71
226,Luke Kornet\kornelu01,C,24,CHI,9,0,110,14,40,.350,5,21,.238,9,19,.474,.413,5,5,1.000,5,13,18,6,1,7,3,10,38
227,Kyle Korver\korveky01,SG,38,MIL,8,0,127,20,44,.455,17,35,.486,3,9,.333,.648,3,5,.600,4,10,14,1,2,1,7,9,60
228,Rodions Kurucs\kurucro01,SF,21,BRK,7,0,83,6,17,.353,2,3,.667,4,14,.286,.412,2,6,.333,5,14,19,1,3,0,9,14,16
229,Kyle Kuzma\kuzmaky01,PF,24,LAL,4,0,81,15,40,.375,3,23,.130,12,17,.706,.413,3,5,.600,2,13,15,2,0,1,8,5,36
230,Skal Labissière\labissk01,PF,23,POR,9,0,123,23,39,.590,0,1,.000,23,38,.605,.590,8,12,.667,19,13,32,6,1,8,11,28,54
231,Jeremy Lamb\lambje01,SG,27,IND,5,5,165,31,68,.456,6,21,.286,25,47,.532,.500,17,20,.850,5,27,32,11,7,4,6,14,85
232,Romeo Langford\langfro01,SG,20,BOS,1,0,0,0,0,,0,0,,0,0,,,0,0,,0,0,0,0,0,0,0,0,0
233,Zach LaVine\lavinza01,SG,24,CHI,9,9,290,67,152,.441,22,57,.386,45,95,.474,.513,28,37,.757,12,31,43,36,11,5,30,23,184
234,Jake Layman\laymaja01,PF,25,MIN,8,0,202,30,75,.400,11,31,.355,19,44,.432,.473,5,6,.833,6,15,21,5,7,5,10,18,76
235,T.J. Leaf\leaftj01,PF,22,IND,7,1,87,12,31,.387,2,6,.333,10,25,.400,.419,2,2,1.000,11,18,29,4,3,1,5,13,28
236,Courtney Lee\leeco01,SG,34,DAL,3,3,26,4,9,.444,0,3,.000,4,6,.667,.444,0,0,,0,1,1,0,0,0,0,2,8
237,Damion Lee\leeda03,SG,27,GSW,9,0,196,29,73,.397,11,28,.393,18,45,.400,.473,28,33,.848,8,28,36,18,7,0,12,17,97
238,Alex Len\lenal01,C,26,ATL,8,8,141,12,37,.324,2,15,.133,10,22,.455,.351,6,9,.667,9,29,38,8,3,12,8,16,32
239,Kawhi Leonard\leonaka01,SF,28,LAC,7,7,216,73,158,.462,11,36,.306,62,122,.508,.497,46,53,.868,10,47,57,38,15,8,24,18,203
240,Meyers Leonard\leoname01,C,27,MIA,9,9,177,27,45,.600,11,17,.647,16,28,.571,.722,4,6,.667,3,32,35,7,5,6,8,26,69
241,Caris LeVert\leverca01,SG,25,BRK,8,8,258,55,130,.423,13,36,.361,42,94,.447,.473,20,31,.645,10,33,43,31,6,1,29,20,143
242,Damian Lillard\lillada01,PG,29,POR,9,9,342,102,206,.495,37,93,.398,65,113,.575,.585,59,65,.908,4,41,45,62,12,4,23,19,300
243,Nassir Little\littlna01,SF,19,POR,2,0,21,3,6,.500,0,0,,3,6,.500,.500,2,2,1.000,1,2,3,0,1,1,0,4,8
244,Kevon Looney\looneke01,C,23,GSW,1,1,10,1,4,.250,1,1,1.000,0,3,.000,.375,0,0,,5,4,9,1,0,0,1,3,3
245,Brook Lopez\lopezbr01,C,31,MIL,9,9,242,28,77,.364,13,47,.277,15,30,.500,.448,19,21,.905,5,34,39,16,6,20,11,22,88
246,Robin Lopez\lopezro01,C,31,MIL,9,0,136,15,34,.441,3,16,.188,12,18,.667,.485,5,11,.455,4,16,20,6,2,5,8,16,38
247,Kevin Love\loveke01,PF,31,CLE,8,8,264,46,93,.495,18,49,.367,28,44,.636,.591,38,45,.844,8,105,113,31,7,5,26,15,148
248,Kyle Lowry\lowryky01,PG,33,TOR,8,8,289,54,113,.478,29,68,.426,25,45,.556,.606,37,42,.881,2,32,34,52,9,3,27,23,174
249,Trey Lyles\lylestr01,PF,24,SAS,8,8,162,14,29,.483,3,11,.273,11,18,.611,.534,3,6,.500,17,45,62,12,1,1,4,12,34
250,Daryl Macon\maconda01,SG,24,MIA,1,0,1,0,0,,0,0,,0,0,,,0,0,,0,0,0,0,0,0,0,0,0
251,Josh Magette\magetjo01,PG,30,ORL,1,0,6,2,4,.500,0,0,,2,4,.500,.500,0,0,,1,0,1,1,1,0,0,0,4
252,Thon Maker\makerth01,C,22,DET,10,0,135,10,24,.417,2,7,.286,8,17,.471,.458,6,11,.545,5,19,24,4,4,8,7,19,28
253,Terance Mann\mannte01,SG,23,LAC,5,0,16,2,3,.667,0,0,,2,3,.667,.667,0,0,,1,4,5,5,1,0,2,3,4
254,Boban Marjanović\marjabo01,C,31,DAL,3,0,28,8,17,.471,0,0,,8,17,.471,.471,0,1,.000,5,10,15,1,0,0,3,5,16
255,Lauri Markkanen\markkla01,PF,22,CHI,9,9,272,44,112,.393,17,56,.304,27,56,.482,.469,31,40,.775,10,58,68,20,8,5,17,13,136
256,Caleb Martin\martica02,SF,24,CHO,3,0,25,2,9,.222,0,3,.000,2,6,.333,.222,1,3,.333,0,4,4,3,1,2,3,2,5
257,Cody Martin\martico01,SF,24,CHO,7,0,82,4,12,.333,0,4,.000,4,8,.500,.333,7,9,.778,3,17,20,7,6,1,1,6,15
258,Kelan Martin\martike03,SF,24,MIN,1,0,5,0,3,.000,0,1,.000,0,2,.000,.000,0,0,,0,1,1,0,0,0,0,1,0
259,Garrison Mathews\mathega01,SG,23,WAS,2,0,14,0,2,.000,0,2,.000,0,0,,.000,0,0,,0,1,1,2,0,0,1,3,0
260,Wesley Matthews\matthwe02,SG,33,MIL,9,9,210,22,51,.431,12,37,.324,10,14,.714,.549,2,3,.667,1,16,17,8,8,1,4,9,58
261,Patrick McCaw\mccawpa01,SF,24,TOR,2,0,40,3,5,.600,1,3,.333,2,2,1.000,.700,1,2,.500,2,4,6,3,3,0,3,3,8
262,CJ McCollum\mccolcj01,SG,28,POR,9,9,335,68,179,.380,15,46,.326,53,133,.398,.422,24,26,.923,7,27,34,28,6,3,23,32,175
263,T.J. McConnell\mccontj01,PG,27,IND,9,0,143,23,49,.469,0,1,.000,23,48,.479,.469,4,4,1.000,6,19,25,38,5,2,10,12,50
264,Jalen McDaniels\mcdanja01,PF,22,CHO,1,0,3,1,2,.500,0,0,,1,2,.500,.500,0,0,,1,0,1,0,0,0,0,0,2
265,Doug McDermott\mcderdo01,PF,28,IND,9,0,175,26,62,.419,14,31,.452,12,31,.387,.532,5,6,.833,3,17,20,14,2,1,10,21,71
266,JaVale McGee\mcgeeja01,C,32,LAL,8,8,130,22,32,.688,0,0,,22,32,.688,.688,3,6,.500,14,26,40,6,3,9,8,14,47
267,Rodney McGruder\mcgruro01,SG,28,LAC,5,0,63,0,7,.000,0,3,.000,0,4,.000,.000,0,0,,2,8,10,1,0,1,2,9,0
268,Alfonzo McKinnie\mckinal01,SF,27,CLE,4,0,14,1,1,1.000,1,1,1.000,0,0,,1.500,0,0,,1,2,3,0,0,0,1,3,3
269,Jordan McLaughlin\mclaujo01,PG,23,MIN,2,0,37,3,11,.273,1,6,.167,2,5,.400,.318,1,1,1.000,0,3,3,2,1,0,2,2,8
270,Ben McLemore\mclembe01,SG,26,HOU,8,0,121,14,38,.368,12,35,.343,2,3,.667,.526,7,9,.778,0,2,2,6,3,0,3,11,47
271,Jordan McRae\mcraejo01,SG,28,WAS,3,0,34,5,11,.455,1,3,.333,4,8,.500,.500,2,2,1.000,1,7,8,4,0,0,3,5,13
272,Nicolò Melli\mellini01,C,29,NOP,7,3,96,15,29,.517,5,16,.313,10,13,.769,.603,8,10,.800,4,13,17,7,1,2,7,12,43
273,De'Anthony Melton\meltode01,PG,21,MEM,3,0,14,0,4,.000,0,1,.000,0,3,.000,.000,0,2,.000,1,0,1,3,2,0,2,0,0
274,Chimezie Metu\metuch01,PF,22,SAS,2,0,5,0,1,.000,0,0,,0,1,.000,.000,0,0,,0,0,0,0,0,0,0,0,0
275,Khris Middleton\middlkh01,SF,28,MIL,9,9,285,61,132,.462,24,59,.407,37,73,.507,.553,29,33,.879,7,46,53,24,7,1,21,27,175
276,C.J. Miles\milescj01,SG,32,WAS,3,0,58,9,26,.346,4,14,.286,5,12,.417,.423,5,5,1.000,3,6,9,4,0,3,0,7,27
277,Malcolm Miller\millema01,SG,26,TOR,2,0,9,0,1,.000,0,1,.000,0,0,,.000,0,0,,0,4,4,0,0,0,0,2,0
278,Patty Mills\millspa02,PG,31,SAS,8,0,170,31,64,.484,19,38,.500,12,26,.462,.633,12,14,.857,2,11,13,13,9,0,10,18,93
279,Paul Millsap\millspa01,PF,34,DEN,8,8,204,30,69,.435,11,22,.500,19,47,.404,.514,24,25,.960,11,34,45,9,6,6,6,23,95
280,Shake Milton\miltosh01,SG,23,PHI,3,0,26,6,12,.500,4,9,.444,2,3,.667,.667,3,4,.750,0,2,2,3,0,0,4,5,19
281,Donovan Mitchell\mitchdo01,SG,23,UTA,9,9,311,84,172,.488,15,35,.429,69,137,.504,.532,40,53,.755,11,32,43,37,16,1,22,26,223
282,Malik Monk\monkma01,SG,21,CHO,8,0,148,24,53,.453,7,27,.259,17,26,.654,.519,2,3,.667,1,11,12,17,2,2,13,14,57
283,E'Twaun Moore\mooreet01,SG,30,NOP,3,0,45,8,18,.444,2,7,.286,6,11,.545,.500,3,4,.750,2,7,9,4,0,0,0,3,21
284,Ja Morant\moranja01,PG,20,MEM,8,8,220,59,120,.492,6,13,.462,53,107,.495,.517,27,36,.750,9,19,28,44,9,2,36,19,151
285,Marcus Morris\morrima03,PF,30,NYK,9,9,312,55,127,.433,24,50,.480,31,77,.403,.528,38,45,.844,9,42,51,11,12,7,17,30,172
286,Markieff Morris\morrima02,PF,30,DET,10,10,269,45,96,.469,15,40,.375,30,56,.536,.547,15,21,.714,4,33,37,18,8,1,25,27,120
287,Monte Morris\morrimo01,PG,24,DEN,8,0,134,20,53,.377,3,6,.500,17,47,.362,.406,7,8,.875,1,10,11,26,3,1,5,5,50
288,Johnathan Motley\motlejo01,PF,24,LAC,2,0,4,1,3,.333,1,1,1.000,0,2,.000,.500,0,0,,1,1,2,2,0,0,2,1,3
289,Emmanuel Mudiay\mudiaem01,PG,23,UTA,6,0,110,23,49,.469,2,11,.182,21,38,.553,.490,6,8,.750,1,13,14,21,3,3,14,9,54
290,Dejounte Murray\murrade01,PG,23,SAS,7,7,162,35,69,.507,2,9,.222,33,60,.550,.522,18,24,.750,9,47,56,38,12,4,20,15,90
291,Jamal Murray\murraja01,PG,22,DEN,8,8,267,57,122,.467,12,34,.353,45,88,.511,.516,28,33,.848,7,33,40,36,8,3,19,17,154
292,Džanan Musa\musadz01,SG,20,BRK,3,0,11,1,3,.333,0,2,.000,1,1,1.000,.333,0,0,,0,1,1,0,0,0,2,1,2
293,Mike Muscala\muscami01,C,28,OKC,7,0,78,4,25,.160,1,19,.053,3,6,.500,.180,4,4,1.000,2,13,15,5,1,3,2,14,13
294,Sviatoslav Mykhailiuk\mykhasv01,SG,22,DET,5,0,83,8,19,.421,7,14,.500,1,5,.200,.605,2,2,1.000,0,6,6,8,0,1,6,1,25
295,Abdel Nader\naderab01,SF,26,OKC,4,0,41,4,11,.364,3,8,.375,1,3,.333,.500,1,2,.500,1,6,7,1,0,0,5,4,12
296,Larry Nance\nancela02,C,27,CLE,8,0,191,28,58,.483,9,24,.375,19,34,.559,.560,12,16,.750,12,38,50,10,4,4,8,15,77
297,Shabazz Napier\napiesh01,PG,28,MIN,6,0,133,13,43,.302,7,31,.226,6,12,.500,.384,14,16,.875,1,14,15,27,9,3,12,4,47
298,Raul Neto\netora01,PG,27,PHI,7,1,89,15,26,.577,4,5,.800,11,21,.524,.654,0,0,,1,9,10,16,4,1,9,2,34
299,Georges Niang\niangge01,PF,26,UTA,8,0,80,9,19,.474,4,13,.308,5,6,.833,.579,5,6,.833,0,9,9,3,0,0,4,14,27
300,Nerlens Noel\noelne01,C,25,OKC,8,2,136,23,32,.719,0,0,,23,32,.719,.719,12,15,.800,9,29,38,11,7,12,9,19,58
301,Zach Norvell\norveza01,SG,22,LAL,2,0,5,0,1,.000,0,0,,0,1,.000,.000,0,0,,0,1,1,0,0,0,0,0,0
302,Jaylen Nowell\nowelja01,SG,20,MIN,1,0,1,0,0,,0,0,,0,0,,,0,0,,0,0,0,0,0,0,0,0,0
303,Frank Ntilikina\ntilila01,PG,21,NYK,8,4,184,18,46,.391,8,19,.421,10,27,.370,.478,0,2,.000,5,13,18,19,10,7,9,17,44
304,Kendrick Nunn\nunnke01,SG,24,MIA,9,9,256,59,129,.457,19,52,.365,40,77,.519,.531,12,14,.857,0,20,20,23,14,3,19,23,149
305,David Nwaba\nwabada01,SG,27,BRK,5,0,64,3,5,.600,1,2,.500,2,3,.667,.700,1,4,.250,2,11,13,1,2,2,5,8,8
306,Royce O'Neale\onealro01,PF,26,UTA,9,8,258,23,41,.561,10,20,.500,13,21,.619,.683,2,2,1.000,1,41,42,17,6,4,9,27,58
307,Kyle O'Quinn\oquinky01,C,29,PHI,7,0,68,14,26,.538,4,10,.400,10,16,.625,.615,2,6,.333,10,14,24,7,1,3,5,10,34
308,Semi Ojeleye\ojelese01,PF,25,BOS,7,0,76,2,7,.286,0,4,.000,2,3,.667,.286,3,5,.600,1,8,9,2,1,0,0,6,7
309,Jahlil Okafor\okafoja01,C,24,NOP,8,5,143,30,47,.638,0,0,,30,47,.638,.638,15,22,.682,13,26,39,10,3,10,15,25,75
310,Elie Okobo\okoboel01,PG,22,PHO,4,0,11,3,5,.600,1,2,.500,2,3,.667,.700,0,2,.000,0,2,2,2,0,0,0,1,7
311,Josh Okogie\okogijo01,SG,21,MIN,8,1,185,24,47,.511,4,15,.267,20,32,.625,.553,17,26,.654,12,29,41,16,12,2,14,20,69
312,KZ Okpala\okpalkz01,SF,20,MIA,2,0,3,0,0,,0,0,,0,0,,,0,0,,0,1,1,0,0,0,1,0,0
313,Kelly Olynyk\olynyke01,C,28,MIA,9,0,195,21,61,.344,12,38,.316,9,23,.391,.443,9,12,.750,8,38,46,15,9,5,14,33,63
314,Cedi Osman\osmande01,SF,24,CLE,8,8,250,29,67,.433,17,37,.459,12,30,.400,.560,4,6,.667,3,22,25,16,9,2,8,20,79
315,Kelly Oubre\oubreke01,SF,24,PHO,8,8,241,49,101,.485,11,29,.379,38,72,.528,.540,28,36,.778,12,32,44,14,8,8,12,28,137
316,Jabari Parker\parkeja01,PF,24,ATL,8,3,204,53,93,.570,9,30,.300,44,63,.698,.618,16,21,.762,12,28,40,10,6,3,16,21,131
317,Eric Paschall\pascher01,PF,23,GSW,9,5,275,53,98,.541,6,19,.316,47,79,.595,.571,36,40,.900,9,29,38,14,4,4,12,19,148
318,Patrick Patterson\pattepa01,PF,30,LAC,9,9,194,15,45,.333,11,32,.344,4,13,.308,.456,2,4,.500,8,29,37,11,2,1,5,12,43
319,Justin Patton\pattoju01,C,22,OKC,1,0,6,0,2,.000,0,1,.000,0,1,.000,.000,0,0,,0,2,2,0,0,0,1,3,0
320,Chris Paul\paulch01,PG,34,OKC,8,8,237,41,91,.451,17,37,.459,24,54,.444,.544,29,36,.806,2,24,26,38,13,0,20,17,128
321,Elfrid Payton\paytoel01,PG,25,NYK,4,3,102,11,29,.379,5,8,.625,6,21,.286,.466,5,6,.833,3,9,12,15,10,0,7,8,32
322,Theo Pinson\pinsoth01,SG,24,BRK,1,0,1,0,0,,0,0,,0,0,,,0,0,,0,1,1,1,1,0,0,0,0
323,Mason Plumlee\plumlma01,C,29,DEN,8,0,130,19,34,.559,0,1,.000,19,33,.576,.559,11,19,.579,14,26,40,20,7,5,9,23,49
324,Vincent Poirier\poirivi01,C,26,BOS,3,0,18,2,6,.333,0,0,,2,6,.333,.333,0,0,,4,0,4,0,1,1,2,5,4
325,Jakob Pöltl\poeltja01,C,24,SAS,8,0,120,12,23,.522,0,0,,12,23,.522,.522,7,11,.636,16,21,37,8,3,7,6,15,31
326,Jordan Poole\poolejo01,SG,20,GSW,9,6,233,26,99,.263,16,54,.296,10,45,.222,.343,23,23,1.000,1,15,16,16,6,3,13,20,91
327,Kevin Porter\porteke02,SG,19,CLE,7,0,129,15,44,.341,3,15,.200,12,29,.414,.375,12,12,1.000,3,14,17,8,2,4,9,17,45
328,Michael Porter\portemi01,PF,21,DEN,4,0,40,9,14,.643,1,4,.250,8,10,.800,.679,5,8,.625,3,6,9,1,0,0,2,3,24
329,Otto Porter\porteot01,SF,26,CHI,9,9,226,35,84,.417,16,40,.400,19,44,.432,.512,15,20,.750,8,23,31,14,9,3,7,20,101
330,Bobby Portis\portibo01,C,24,NYK,9,2,215,36,90,.400,8,25,.320,28,65,.431,.444,10,14,.714,21,50,71,12,5,3,9,20,90
331,Kristaps Porziņģis\porzikr01,PF,24,DAL,8,8,263,58,136,.426,20,52,.385,38,84,.452,.500,25,37,.676,8,58,66,14,2,21,17,28,161
332,Dwight Powell\poweldw01,PF,28,DAL,5,5,127,15,26,.577,1,3,.333,14,23,.609,.596,9,14,.643,11,15,26,2,3,0,7,13,40
333,Norman Powell\powelno01,SG,26,TOR,8,0,194,24,57,.421,9,31,.290,15,26,.577,.500,13,16,.813,3,28,31,10,8,0,12,12,70
334,Julius Randle\randlju01,PF,25,NYK,9,9,302,53,122,.434,6,31,.194,47,91,.516,.459,23,38,.605,25,59,84,38,7,2,37,27,135
335,Cam Reddish\reddica01,SF,20,ATL,8,8,199,17,65,.262,6,27,.222,11,38,.289,.308,10,12,.833,5,25,30,14,9,2,16,14,50
336,J.J. Redick\redicjj01,SG,35,NOP,8,4,184,24,62,.387,18,42,.429,6,20,.300,.532,9,13,.692,2,12,14,11,2,3,13,9,75
337,Josh Richardson\richajo01,SG,26,PHI,8,8,274,39,97,.402,9,35,.257,30,62,.484,.448,22,25,.880,6,21,27,32,13,7,23,24,109
338,Austin Rivers\riverau01,SG,27,HOU,8,0,155,20,46,.435,12,29,.414,8,17,.471,.565,3,6,.500,3,14,17,12,0,0,3,17,55
339,Duncan Robinson\robindu01,PF,25,MIA,9,4,197,28,63,.444,19,48,.396,9,15,.600,.595,4,4,1.000,1,23,24,6,3,6,4,17,79
340,Glenn Robinson\robingl02,SF,26,GSW,9,9,282,36,79,.456,9,23,.391,27,56,.482,.513,10,12,.833,24,35,59,15,8,2,10,17,91
341,Jerome Robinson\robinje01,SG,22,LAC,5,0,39,6,16,.375,2,5,.400,4,11,.364,.438,0,0,,0,5,5,4,1,0,7,2,14
342,Justin Robinson\robinju01,PG,22,WAS,3,0,12,2,5,.400,1,1,1.000,1,4,.250,.500,0,0,,1,2,3,2,0,0,2,0,5
343,Mitchell Robinson\robinmi01,C,21,NYK,7,6,123,28,39,.718,0,0,,28,39,.718,.718,11,15,.733,21,21,42,4,5,13,5,22,67
344,Derrick Rose\rosede01,PG,31,DET,6,0,150,50,89,.562,1,4,.250,49,85,.576,.567,24,27,.889,2,7,9,38,6,3,23,8,125
345,Terrence Ross\rosste01,SG,28,ORL,7,0,155,20,71,.282,8,42,.190,12,29,.414,.338,10,11,.909,4,19,23,10,6,2,11,14,58
346,Terry Rozier\roziete01,PG,25,CHO,8,8,255,42,109,.385,15,45,.333,27,64,.422,.454,22,28,.786,5,27,32,41,8,3,27,22,121
347,Ricky Rubio\rubiori01,PG,29,PHO,7,7,225,27,73,.370,7,20,.350,20,53,.377,.418,26,30,.867,4,46,50,57,12,0,18,24,87
348,D'Angelo Russell\russeda01,SG,23,GSW,6,6,192,51,120,.425,18,52,.346,33,68,.485,.500,27,36,.750,2,25,27,37,3,3,13,7,147
349,Domantas Sabonis\sabondo01,C,23,IND,7,7,248,55,104,.529,3,9,.333,52,95,.547,.543,26,30,.867,23,65,88,26,5,5,18,29,139
350,JaKarr Sampson\sampsja02,SF,26,IND,5,4,101,18,33,.545,1,8,.125,17,25,.680,.561,2,7,.286,6,11,17,2,3,5,3,13,39
351,Dario Šarić\saricda01,PF,25,PHO,8,8,218,27,69,.391,11,34,.324,16,35,.457,.471,6,9,.667,11,38,49,17,11,2,13,15,71
352,Tomáš Satoranský\satorto01,PG,28,CHI,9,9,237,28,59,.475,11,22,.500,17,37,.459,.568,12,13,.923,8,17,25,51,10,2,17,19,79
353,Admiral Schofield\schofad01,SF,22,WAS,5,0,51,7,10,.700,4,7,.571,3,3,1.000,.900,4,4,1.000,2,6,8,1,0,0,0,3,22
354,Dennis Schröder\schrode01,PG,26,OKC,8,0,230,41,103,.398,8,30,.267,33,73,.452,.437,16,21,.762,6,34,40,36,8,2,22,25,106
355,Mike Scott\scottmi01,PF,31,PHI,8,0,137,20,41,.488,9,24,.375,11,17,.647,.598,5,5,1.000,7,17,24,5,2,0,4,19,54
356,Thabo Sefolosha\sefolth01,SF,35,HOU,7,0,79,5,18,.278,3,11,.273,2,7,.286,.361,0,0,,8,15,23,10,2,3,4,7,13
357,Collin Sexton\sextoco01,PG,21,CLE,8,8,248,52,124,.419,14,37,.378,38,87,.437,.476,20,25,.800,5,19,24,16,3,1,14,22,138
358,Landry Shamet\shamela01,SG,22,LAC,9,9,276,28,72,.389,19,53,.358,9,19,.474,.521,10,10,1.000,0,14,14,15,4,1,11,27,85
359,Pascal Siakam\siakapa01,PF,25,TOR,8,8,277,83,160,.519,19,46,.413,64,114,.561,.578,38,40,.950,15,59,74,29,6,1,26,32,223
360,Chris Silva\silvach01,PF,23,MIA,9,0,63,9,13,.692,0,0,,9,13,.692,.692,6,6,1.000,14,7,21,4,3,8,8,17,24
361,Ben Simmons\simmobe01,PG,23,PHI,7,7,223,39,79,.494,0,0,,39,79,.494,.494,14,25,.560,6,32,38,48,21,3,26,21,92
362,Anfernee Simons\simonan01,SG,20,POR,9,0,180,36,76,.474,14,37,.378,22,39,.564,.566,13,17,.765,2,14,16,9,6,2,9,17,99
363,Marcus Smart\smartma01,SG,25,BOS,7,3,215,23,66,.348,14,43,.326,9,23,.391,.455,7,9,.778,4,21,25,33,9,2,6,20,67
364,Dennis Smith\smithde03,PG,22,NYK,3,0,26,1,11,.091,0,3,.000,1,8,.125,.091,1,2,.500,0,1,1,3,1,1,2,6,3
365,Ish Smith\smithis01,PG,31,WAS,8,5,209,26,62,.419,5,19,.263,21,43,.488,.460,4,7,.571,6,16,22,35,4,3,9,18,61
366,Tony Snell\snellto01,SF,28,DET,10,10,289,36,79,.456,24,54,.444,12,25,.480,.608,2,2,1.000,5,11,16,19,6,2,4,19,98
367,Omari Spellman\spellom01,PF,22,GSW,9,0,148,21,50,.420,3,12,.250,18,38,.474,.450,16,19,.842,22,29,51,13,7,6,12,12,61
368,Edmond Sumner\sumneed01,PG,24,IND,3,2,67,9,18,.500,0,3,.000,9,15,.600,.500,3,5,.600,1,2,3,6,5,1,1,9,21
369,Caleb Swanigan\swanica01,PF,22,SAC,4,0,11,1,2,.500,0,0,,1,2,.500,.500,1,2,.500,1,3,4,0,1,2,3,3,3
370,Jayson Tatum\tatumja01,PF,21,BOS,7,7,242,57,133,.429,22,48,.458,35,85,.412,.511,15,20,.750,10,44,54,13,11,6,14,15,151
371,Jeff Teague\teaguje01,PG,31,MIN,6,6,158,26,52,.500,5,15,.333,21,37,.568,.548,22,25,.880,0,13,13,38,8,1,14,16,79
372,Garrett Temple\templga01,SG,33,BRK,8,0,166,19,43,.442,11,30,.367,8,13,.615,.570,7,9,.778,4,18,22,12,11,4,5,9,56
373,Daniel Theis\theisda01,C,27,BOS,6,5,130,11,34,.324,1,7,.143,10,27,.370,.338,7,11,.636,9,31,40,5,0,15,4,18,30
374,Isaiah Thomas\thomais02,PG,30,WAS,6,3,136,30,70,.429,12,33,.364,18,37,.486,.514,7,7,1.000,1,12,13,37,2,2,16,11,79
375,Khyri Thomas\thomakh01,SG,23,DET,2,0,6,0,0,,0,0,,0,0,,,1,2,.500,0,0,0,0,0,0,0,0,1
376,Matt Thomas\thomama02,SG,25,TOR,5,0,53,7,11,.636,6,10,.600,1,1,1.000,.909,2,2,1.000,1,5,6,0,3,0,3,5,22
377,Tristan Thompson\thomptr01,C,28,CLE,8,8,272,60,109,.550,1,3,.333,59,106,.557,.555,18,30,.600,41,52,93,22,7,13,5,21,139
378,Matisse Thybulle\thybuma01,SG,22,PHI,7,2,121,8,33,.242,5,21,.238,3,12,.250,.318,6,10,.600,2,6,8,9,14,7,13,22,27
379,Anthony Tolliver\tollian01,PF,34,POR,9,5,152,7,28,.250,6,22,.273,1,6,.167,.357,6,7,.857,5,22,27,8,2,4,5,8,26
380,Karl-Anthony Towns\townska01,C,24,MIN,6,6,193,52,104,.500,23,51,.451,29,53,.547,.611,27,39,.692,16,57,73,22,10,10,15,20,154
381,Gary Trent\trentga02,SG,21,POR,5,0,29,1,5,.200,1,4,.250,0,1,.000,.300,0,0,,1,3,4,1,1,0,1,2,3
382,Allonzo Trier\trieral01,SG,24,NYK,6,1,96,11,28,.393,6,16,.375,5,12,.417,.500,16,21,.762,1,9,10,9,2,2,10,15,44
383,P.J. Tucker\tuckepj01,PF,34,HOU,8,8,275,34,62,.548,20,41,.488,14,21,.667,.710,4,4,1.000,16,41,57,17,10,3,12,28,92
384,Evan Turner\turneev01,PG,31,ATL,3,0,34,4,7,.571,0,1,.000,4,6,.667,.571,4,5,.800,0,3,3,7,3,0,2,2,12
385,Myles Turner\turnemy01,C,23,IND,4,4,126,22,40,.550,8,15,.533,14,25,.560,.650,7,9,.778,9,18,27,2,2,5,7,8,59
386,Jonas Valančiūnas\valanjo01,C,27,MEM,8,8,174,38,78,.487,6,15,.400,32,63,.508,.526,13,14,.929,14,62,76,16,2,4,18,19,95
387,Denzel Valentine\valende01,SG,26,CHI,1,0,5,1,4,.250,1,2,.500,0,2,.000,.375,0,0,,1,0,1,0,0,0,0,0,3
388,Jarred Vanderbilt\vandeja01,PF,20,DEN,2,0,7,0,0,,0,0,,0,0,,,0,0,,0,1,1,1,0,0,1,0,0
389,Fred VanVleet\vanvlfr01,SG,25,TOR,8,8,298,35,100,.350,19,48,.396,16,52,.308,.445,32,34,.941,1,32,33,59,10,1,18,18,121
390,Noah Vonleh\vonleno01,C,24,MIN,8,0,111,15,30,.500,1,8,.125,14,22,.636,.517,8,9,.889,11,24,35,9,4,2,7,9,39
391,Nikola Vučević\vucevni01,C,29,ORL,9,9,282,60,139,.432,7,32,.219,53,107,.495,.457,26,30,.867,22,76,98,29,8,8,12,15,153
392,Moritz Wagner\wagnemo01,C,22,WAS,8,0,142,33,55,.600,7,18,.389,26,37,.703,.664,13,15,.867,12,30,42,2,5,10,19,31,86
393,Kemba Walker\walkeke02,PG,29,BOS,7,7,237,50,126,.397,26,63,.413,24,63,.381,.500,44,48,.917,10,26,36,28,7,4,17,13,170
394,Lonnie Walker\walkelo01,SG,21,SAS,5,0,15,1,4,.250,0,1,.000,1,3,.333,.250,1,2,.500,0,4,4,0,0,0,2,3,3
395,Tyrone Wallace\wallaty01,SG,25,ATL,5,0,63,10,20,.500,0,4,.000,10,16,.625,.500,4,8,.500,2,8,10,5,2,0,6,8,24
396,Taurean Waller-Prince\princta02,SF,25,BRK,8,8,258,37,90,.411,23,57,.404,14,33,.424,.539,11,16,.688,9,47,56,12,11,4,17,25,108
397,Derrick Walton\waltode01,PG,24,LAC,2,0,3,0,0,,0,0,,0,0,,,0,0,,0,0,0,0,0,0,0,0,0
398,Brad Wanamaker\wanambr01,PG,30,BOS,7,0,76,9,18,.500,1,3,.333,8,15,.533,.528,6,7,.857,1,11,12,12,5,1,5,10,25
399,T.J. Warren\warretj01,SF,26,IND,9,9,313,70,138,.507,6,25,.240,64,113,.566,.529,15,20,.750,7,24,31,10,13,3,12,26,161
400,PJ Washington\washipj01,PF,21,CHO,8,8,254,41,78,.526,14,31,.452,27,47,.574,.615,14,20,.700,8,43,51,12,8,8,15,21,110
401,Russell Westbrook\westbru01,PG,31,HOU,7,7,230,55,120,.458,8,31,.258,47,89,.528,.492,27,43,.628,13,54,67,61,13,4,28,22,145
402,Coby White\whiteco01,PG,19,CHI,9,0,212,38,106,.358,11,46,.239,27,60,.450,.410,14,20,.700,2,28,30,23,5,0,11,8,101
403,Derrick White\whitede01,PG,25,SAS,8,1,181,33,64,.516,7,17,.412,26,47,.553,.570,22,26,.846,6,16,22,16,4,4,7,22,95
404,Hassan Whiteside\whiteha01,C,30,POR,8,8,217,46,81,.568,0,0,,46,81,.568,.568,21,29,.724,33,73,106,6,4,15,17,25,113
405,Andrew Wiggins\wiggian01,SF,24,MIN,8,8,273,76,165,.461,18,54,.333,58,111,.523,.515,27,39,.692,12,26,38,23,4,9,12,21,197
406,Grant Williams\willigr01,PF,21,BOS,7,0,116,8,26,.308,0,10,.000,8,16,.500,.308,7,9,.778,8,10,18,9,5,3,4,13,23
407,Kenrich Williams\willike04,PF,25,NOP,8,0,138,13,33,.394,7,20,.350,6,13,.462,.500,5,9,.556,10,21,31,12,7,5,3,21,38
408,Lou Williams\willilo02,SG,33,LAC,9,2,283,63,156,.404,15,43,.349,48,113,.425,.452,61,73,.836,5,28,33,52,3,3,27,14,202
409,Marvin Williams\willima02,PF,33,CHO,8,0,142,22,42,.524,11,26,.423,11,16,.688,.655,5,6,.833,4,14,18,5,4,1,4,11,60
410,Robert Williams\williro04,C,22,BOS,6,1,89,13,18,.722,0,0,,13,18,.722,.722,4,8,.500,8,21,29,12,8,6,6,17,30
411,Nigel Williams-Goss\willini01,PG,25,UTA,3,0,7,0,1,.000,0,1,.000,0,0,,.000,0,0,,0,0,0,1,0,0,1,1,0
412,D.J. Wilson\wilsodj01,PF,23,MIL,4,0,17,2,9,.222,1,7,.143,1,2,.500,.278,0,0,,0,4,4,2,0,0,1,1,5
413,Justise Winslow\winslju01,SF,23,MIA,5,5,181,28,72,.389,3,12,.250,25,60,.417,.410,10,17,.588,9,31,40,24,5,3,16,17,69
414,Christian Wood\woodch01,PF,24,DET,9,0,132,25,41,.610,8,14,.571,17,27,.630,.707,12,18,.667,8,28,36,3,1,7,9,5,70
415,Delon Wright\wrighde01,SG,27,DAL,8,2,192,26,48,.542,6,12,.500,20,36,.556,.604,9,10,.900,3,22,25,29,10,1,5,11,67
416,Thaddeus Young\youngth01,PF,31,CHI,9,0,197,38,81,.469,12,35,.343,26,46,.565,.543,1,8,.125,7,25,32,13,11,3,13,16,89
417,Trae Young\youngtr01,PG,21,ATL,7,7,217,61,128,.477,22,56,.393,39,72,.542,.563,31,38,.816,4,23,27,57,11,0,32,7,175
418,Cody Zeller\zelleco01,C,27,CHO,7,7,181,32,66,.485,4,15,.267,28,51,.549,.515,14,20,.700,27,46,73,10,3,3,10,16,82
419,Ivica Zubac\zubaciv01,C,22,LAC,9,8,145,32,47,.681,0,0,,32,47,.681,.681,22,26,.846,22,39,61,5,2,13,8,18,86